-1-
1;1;1;1;1;1;0;0;0;0;1;1;1;1;1;1
1;1;1;1;1;1;0;0;0;0;1;1;1;1;1;1
1;1;1;1;1;1;0;0;0;0;1;1;1;1;1;1
1;1;1;1;0;0;0;0;0;0;0;0;1;1;1;1
1;1;1;1;0;0;0;0;0;0;0;0;1;1;1;1
1;1;1;1;0;0;0;0;0;0;0;0;1;1;1;1
1;1;1;0;0;0;0;0;0;0;0;0;0;1;1;1
1;1;1;60;0;0;0;0;0;0;0;0;0;1;1;1
1;1;1;0;0;0;0;0;0;0;0;0;0;1;1;1
1;1;1;1;0;0;0;0;0;0;0;0;1;1;1;1
1;1;1;1;1;0;0;0;0;0;0;1;1;1;1;1
1;1;1;1;1;1;1;1;1;1;1;1;1;1;1;1
-2-
1;1;1;1;1;1;0;0;0;1;1;1;1;1;1;1
1;1;1;1;1;1;0;0;0;0;1;1;1;1;1;1
1;1;1;1;1;0;0;0;0;0;0;1;1;1;1;1
1;1;1;1;0;0;0;0;0;0;0;0;0;1;1;1
1;1;1;1;0;0;0;1;1;0;0;0;0;1;1;1
1;1;1;1;0;0;0;1;1;0;0;0;0;1;1;1
1;1;1;0;0;0;0;1;1;0;0;0;0;1;1;1
1;1;1;0;0;0;0;0;0;0;0;0;0;1;1;1
1;1;1;0;0;0;0;0;0;0;0;0;0;1;1;1
1;1;1;1;0;0;0;0;0;0;0;0;1;1;1;1
1;1;1;1;1;0;0;0;0;0;0;1;1;1;1;1
1;1;1;1;1;1;0;0;0;0;1;1;1;1;1;1
-3-
1;1;1;1;1;1;1;1;1;1;1;0;0;0;1;1
1;1;0;0;0;0;0;0;0;1;1;0;0;0;1;1
1;1;0;0;0;0;0;0;0;0;0;0;0;0;1;1
1;1;1;1;0;0;0;0;0;0;0;0;0;1;1;1
1;1;1;1;0;0;0;0;0;0;0;0;1;1;1;1
1;1;1;1;0;0;0;1;1;1;0;0;1;1;1;1
1;1;1;1;0;0;0;1;1;1;0;0;1;1;1;1
1;1;1;1;1;0;0;1;1;1;0;0;1;1;1;1
1;1;1;1;1;0;0;0;0;0;0;0;0;1;1;1
1;1;0;0;0;0;0;0;0;0;0;0;0;1;1;1
1;1;0;0;0;0;0;0;0;0;0;0;1;1;1;1
1;1;1;1;1;1;0;0;0;1;1;1;1;1;1;1
-4-
1;1;1;1;1;1;1;1;1;1;1;1;1;1;1;1
1;1;1;1;0;0;0;0;0;0;0;0;0;0;0;1
1;1;1;1;0;0;0;0;0;0;0;0;0;0;0;1
1;1;0;0;0;0;1;1;1;1;0;0;0;0;0;1
1;1;0;0;0;0;0;1;1;1;0;0;0;0;1;1
1;1;1;0;0;0;0;1;1;1;0;20;0;0;1;1
1;1;1;1;1;0;0;1;1;1;0;0;0;1;1;1
1;1;1;1;1;0;0;1;1;1;1;1;1;1;1;1
1;1;1;1;1;0;0;1;1;1;1;1;1;1;1;1
1;1;1;0;0;0;0;0;0;0;0;0;0;0;1;1
1;1;1;0;0;0;0;0;0;0;0;0;0;0;1;1
1;1;1;1;1;1;1;1;1;1;1;0;0;0;1;1
